R 1920 1080
NO ./path_to_the_north_texture
SO ./path_to_the_south_texture
WE ./path_to_the_west_texture
EA ./path_to_the_east_texture
S ./path_to_the_sprite_texture
F 25,25,25
C 0,126,233

111111111111111
111010011100011
110101100000001
100111101011001
100000101110111
101110011100011
111011011010001
111100110010111
111110000110101
100001110101101
100011111111101
111001100111111
111101N10001111
110111011100101
111111111111111
