R 1920 1080 
NO ./path_to_the_north_texture
SO ./path_to_the_south_texture
WE ./path_to_the_west_texture
EA ./path_to_the_east_texture
S ./path_to_the_sprite_texture
F 25,25,25
C 0,126,233

11111111111111111111
10000000000000001101
10000000000001000001
11000000000000100101
11000100000000000001
10000100100000001011
10100000000000000001
10002000000010000001
11000010000000000001
1000001000E000000001
10000000000000000001
10000001000100000001
10000010000000000001
10000000000002001001
10000000000000011001
10000000001000000001
10002010001000000001
10000002000000000011
10000010000000000001
11111111111111111111
