R 1920 1080 
NO ./path_to_the_north_texture
SO ./path_to_the_south_texture
WE ./path_to_the_west_texture
EA ./path_to_the_east_texture
S ./path_to_the_sprite_texture
F 25,25,25
C 0,126,233

11111111111111111111
11111111121111011211
11010102211110011101
12001121112121111111
11000201111101111111
11011111111111110121
11111111111111101111
10211001111011012201
12221110112101111201
11111111012111100111
100011101211112W1011
11111210111111010111
11101110211111100001
11110121101111011111
11111111110111112111
11211011100121001111
11110110111001010101
11100011011110021001
12111010111002001121
11111111111111111111
