R 1920 1080 
NO ./path_to_the_north_texture
SO ./path_to_the_south_texture
WE ./path_to_the_west_texture
EA ./path_to_the_east_texture
S ./path_to_the_sprite_texture
F 25,25,25
C 0,126,233

1111111111
1111111011
1111211111
1110110011
1121010211
1101110111
110110N101
1111101101
1110101211
1111111111
