R 1920 1080 
NO ./path_to_the_north_texture
SO ./path_to_the_south_texture
WE ./path_to_the_west_texture
EA ./path_to_the_east_texture
S ./path_to_the_sprite_texture
F 25,25,25
C 0,126,233

1111111111111111111111111111111111111111111111111111111111111111111111111111111111111111111111111111111111111111111111111111111111
1100010010000200110001010011010000000010010000002001001000001000201100001010010100011010000000011001101111101110101000000000001001
1001000001000001010111201010000100100001201010000012000001000001100020200000011000010000120011000001000010000100000001000000010001
1000100101101110000000000001000000000001000000001000000000100000010011100101010000111000100201000000200000100000200101001000010101
1000000000000001000010010010001000011011001010000010100010000010100000001000110010010101000110000001100100000010000100100200110101
1210001010001110000100110000100011001010000000010001000000010010021010001010021000001110012110000000100000000000102011000010101011
1011000111000000010020100010100000000000001000120100010000100000100001101000001000000000110011001000010100000002100000000000010101
1100000010000000000101100110100100000000010000002011000001001100101000001001110100021111000000002000012010000000000010100011000201
1100001001001101001001100001000000000000010000000001001100100110000011100101110001000101200020000000000010000010000000010001100101
1000010000000000110000011000010102000000001120001100000101011000200000000002000000000000000011000110001200001121001000011000000011
1000010001200010001010001010010001101020000011000000010000010010010100010101000000010001100010111000000000011010001111100100001101
1012000100110011010001100100110111010000000020200001000000000001010020001201010000000010000011000100001010001000100100021210000101
1000000000001100000010010020010100010100001101000001001111000110101010000010000001000001000000000000000011000000111000000001010101
1000010000110000200000000001010010100011000000010000000000011021000120000020100001000000000001000000100020010000100000010000100001
1001000010001200000000100000000110010100000000001001101101010001101100110102000000001211000000000000010000000021001001100100000001
1100020000110000001000001000100000000000001000200011000010000002100100100000010110001000000000201100001010100001010011012000102101
1110100000100101001000010100100100201101100010010011000100000000000001011001001000000000010000000011000000001101000000010000110001
1100011010000101001000000000100000000100000010101010100000110100120000110000000000001000010101000100000100100110000000102000002001
1100100110011010012010001000011010110000100021000000000100001000010001200000010010001011100010100100000001100110000011001100001101
1000000000001001000000000220100100010110100000111100000110000110011001000000000011110011001001000100011010200121100010100201000011
1000011001000100112101110120100101001000000010000001000111000001001001000000100101000001000100000000001021020000000000000000101011
1010110100000011011100100000000100000101000000000100000000100020011000010012000110001010010110110001000001000010010000010101101001
1110010001001210000010101011010100000000000100000110101100000110200001000101001110001010001010001100111001011100010001011000000001
1100000110000100100000000101100001000000101001000001000111000000001110010020111110001010101001010000000001110010000110012111001001
1100000001100000010000100000000010100001101101010001111110110001000010011011100001000210010100100000102000001001011000000010000011
1010010010000000001010000001101010000010210101000001010100110100001201001000000100020100000000000000011001101001001110110000211011
1000010010010000110001010100000000000001001000100101001100100010211100000000110011010000001110210010010000000000100000000100000111
1120010000000200000102100100001100010000200000000111011100100000010000010011001100001100000010100001000010101011002001000000000111
1010010000110111200010110000010100010110100010000111001110001010000110010000000001001011200110000000001200001200100000210100001101
1010110101101000100100000100000110120000111101100001111000011000000000100011011001100001000010000001101011000111110000210100000111
1101000000002001000110101010000010100000111100000001011001200010100110000010010010001012000101001100100121010100100110012011010001
1000100000210100000010100000000100120101010000000000000001010100002110000010100010101002010110000110100000101010000010100100000101
1010010001000111010010001210010000010000001010100100200000001000110001110111000000100111010010001000011010200100010000000001001021
1000001201110000010000010000110001000010000001001000001000000100000000000000000002000000000101001000001100000010000011010000020001
1100100001011021000201001000000000001001100011101000000011210000000000011101111112001011002001101000000002000000102012111000010001
1001100100001010101100100010000100000010110010100000011010010000000001000000100000202201110010000000100001000100100110001120001001
1000010011000011020100101000010001000011000100000000010001000011000100001000001001120000000110000110200100100010010110110001100001
1101000000000100100000112011011001001021000000001000000000011100111000011100100000000110000101000000000110010100010101000000010101
1001110001010000011101000000100000200100100100000111002000010000001212100100102010000011111100110100001100110001011010000001000011
1000201200110000001001001000011010001001001101000000000100100000000100000000010010101001000000001001000000110001000000000001001011
1010000100000000000110001000010100000000000201000000001010001010000101010001100000020000000101100110001000000110010000000100000001
1010000000100101101110100000010101100000101100000001100011000000000000000120000111000100000111000001001100000000010000010010000101
1000001000000000001100110100100000000011000010001000001000001002010000020000010000000000001000010000010100000000000000010000001101
1000001110001011010010000001000100100010000100000000101100000000002100010000000001101101001001000101010000001000012100001100000011
1010110001011000210010000000110111011100000000101200110111011010001100001000000110000102001001010010000000200010010001010000000011
1001000110011100001011000110000002100101000111110000000101000100100000100000010010110200000101010100000000010000000000020020000111
1110000000000010000001001101100101100000000010100001000100011110020102000001110100001000001100000100100122111010010000110010001001
1010000111100000110000100010210001000100110000100011000110120001000001000100120122000100000100100100010000000101010111020100001011
1011010010100000010110101001110210010010101010001000100010000000100110001011000211100110001000001000000000001000000000120000000011
1000000100000010000020100000000010010000001000100000100000220000001111010100010110100111110000000000000100100010000001001000000201
1000100001100010100000000100000110012001011000000000010001111010000100000000000110100120000100110100110000011000000101000010000101
1021010100000000201001110001211001010101010010110000000001001002001100000000000011000100010000000000010000100100000020100010010001
1001002001000000011101001011001000001101000000002220010020010110000102010100011010000020001101101000001000101011000000010001010011
1000011010000110010000002110001010000010100001102101011100100100102001000121100100001000010101001000200000101000010001000001010001
1000001100000000100111200000000101010011001000100000100001110110000001010100100021001120001000001000000000110001100100010100011101
1000100012011110000000101100002200002000010000100000010111011010011011100011000100010010000100000100101010000000000100001000201101
1010000000110000000001000000001020010002000011100011000000001000001010020000111001001000000111011000010000101000010100112001110001
1000100000001100110001000000010021010211100100000000000002001101010000000001001100100100000001010000000000000000001100000000101101
1000100010102100100000020001001101001000011000101000120110000000111000010000111000000210100000002010000201001011111000010001001211
1100020100000100200001000100001110101010100000100000001001100100110110110000200011110110000000010100000000001000000000110011010001
1100000001000000000210010000001000000000000000110001000000000000000010010100000000000012001001100101000010001010020000001100100101
1010000101100000000000101010010100011011010000000100E00000100101001110010101010001000100001010100000100100100100000000001100100001
1010000000201100000010001100000110000000000100000000101100000110010011000101010100000000111000001002000110010110000000010010100001
1001010010001201100101010100000000100000010100000001000000100011001010000001010001100001100000000010110000001010010011200101000011
1001100010000100101000000011001010000000011111000101000010101011100011001000111000000101100100000000100010100001001010000111000001
1100210110001000100100100120010000000010000002100100011100100200111100000102001102010000101011000000000011001000201101000000100001
1100000000000201100011001001011000110010001000100010100000000020100001001001200000000002001100001000100000110100100100000000010001
1000100100000100010000000200000111101010000200000100001011100100100100012110010010000011000000000000000010100000010100000012001001
1100100100110012010000101100000000011001001000000001000010100000000000010210000001001010100000001000001010000000000002001000000101
1011002000001100001000001210112010011010010010000000010010000101101010010021020120100110002001000011001010000001000000000000001011
1000110001110000010100000011000001010000100001000001010201100101001000000110010100101011000010000100101011000000000010000100000011
1110200100011100000120001001000011011201100001000100110220010011002010010010000100100010001010000120010000100000010001000000100201
1110001001000011001001010000010010020000100000000111000001000111000010110000001000100010000000000100110000011000000000100200101011
1100001000100000100001011010100110000101000010000001000010101101001102011100002000000000111101110101000021101000000000110100100001
1010000010100000100000010010000020000000001000010001000102000100101001101110000001000000000010010000010101000000110000000000010001
1000000001000000102000000111102100010010000000100000000110000010000001000000110001100000000000000001120000101010100000010010001101
1000101101000012000011101101000000010000010101010001100010001101002010100000101000000000000011000110100001100010001000111110000001
1100200001100001001110000100000020000000000000011000111110111011100100011110100000101000010100020200001001000010110010000011000101
1000000010100000010000100100001100010010111000001000000000001010101100100000000000010000100000000000101100002110110101020110001101
1000010000000200010100102000001000000000000001000001000010010001100000001001000010000001011011000010000000211000000100000000111001
1001000101011000011100001001000001011010110010000001111000001000000010100001000010010100100001101001102101000011101100000000100101
1000000000000010001000000000000110000100100010100000001000001100100000011000000010011000001001000000200020011000000010000001002011
1010000010000010010000011100000000000011010010100010000100000011001100010001000000000101111000000001000011001000110000100000000001
1000010000002020000000011011100110100001000001100001010100100000100100100101000110100210111100110001000000000010010101100000010001
1100110101010110000001011000100000000000001001101010000000100110100000100000000000001000100100001000110010000001001010110110001001
1100000000000010010100000110110100000000001001000002011000000001100010110010000001000010000110000000000000001000100101000000010101
1010110100001000010020000111011001001012000010000000010000010000010100000110010010100000010000100001000010000211000010000010000101
1001000000102001100010100100100110011001111100011010000000111000010010011001000010000101010000122110100100000000000000101001011011
1111111111111111111111111111111111111111111111111111111111111111111111111111111111111111111111111111111111111111111111111111111111
