R 1920 1080 
NO ./path_to_the_north_texture
SO ./path_to_the_south_texture
WE ./path_to_the_west_texture
EA ./path_to_the_east_texture
S ./path_to_the_sprite_texture
F 25,25,25
C 0,126,233

11111111111111111111111111111111111111111111111111111111111111111111111111111111111111111111111111111111
10000000010000000010000100000000120011000101010100100000001000011010011000010010100000110200011001000101
10001011000000011001002000100010011000100000100000100000000100100101010000001101110100100001000000000001
10010000100000000000000001000100020100000100000000100100000000110110000001002001012001000011001100010101
10100110110110001000100110000100000001100001001000000110000010002001100010211101110000020111100010000111
10111110000100000000010001001000000120000001010100100010010000010000000001000010100000000000110000001001
10100010010101000001000111010021001001000000100101000000000100101000100110110100101000010001110101000001
10001000001001111011000001010000000100000000001110000000100000001001110010000000100000001000100210001111
10000000001100001000000020110110001010000101000010000011001010100000000000000000000000010100010101000001
10000001010102000000001110100000020100010000110002011001000000001000100100000000011111010100001000101101
10000100100000001000110010000010101100100001001101010001100001121000000000010010011001111001010110000101
10000000000111001000102000010000100010000011010001000001011110000000100000101010000000101100001011000001
10100000010111000001000010010010110000000010100100101001000100000000000000000000000010100011010200101011
10100000011000000000001100010000010100010000100000020000010000011010000110000000011000100010001010021001
11020111000100010000001000110000010100000002000000012011100000000000110000001100001110000000000001110001
10010100000000000101100001010010000000102000000010100001010010001000000000001000110101000000010100001001
10000001111001000000010100000111000000010011011001000000000010001000100000000000000110100000000101010001
10110010001000010100001001000101001010000010011111100100100001000000001010000000100000001000010000000001
10001000010000011000100100000011110011100010001210101000001101100011011000000000011010000000000000010101
11011100010001001010010000001000000101001100011110000000010010000001010010000011000010102010100000000011
10000010001000100000010000110001000001000200201000001200000010000011000000011000000000001120012000001101
10110001002000012110000101010000000000000000000110100101000010000000000201000000001011001000011111001001
10101010000000000002110000001000001000002000000000000000000200000011000100000010000000101000002101000011
10001101000000100000110001100011000000000110100010000010200000000100000100000000000001101010010000000001
10201000110000000100200000010100100100000011010000010000001001100010100002101000110000000001001002202011
1110000011001000011000100201000001100000000100000001001001020101100000000010000011000000001000N000100001
10100100011001010111000100100000101200100000110100000100000000000011100000001100000200001000100000110101
10011010010100100010010000010000100100010111200000002100020110101100001000000100101100000010001000000001
10100100010000000000001001000010101000000011110010001001220100100101000011010000000020001100000000010101
10000001010000011100100000100111002100000001100010000101010010010000001000000100100100001100000100100001
10001001010100000010001100010010000002000011100110101000000000000010100000000010010000100000000101110001
11001010000100100000020011200001000000201100010011010100001000000000000100011110000100000001001100000201
10001000101000001000000010000100000000000010000011001000000000001100000010100011000001110000100010010101
10000000000001010011000010000101000010000000010011000000001000200010101000000001100000000010100001110001
10000100000000100001001101011001000010000000101010000010010010000100000021000000000000000000011000000001
10101000011100000000000010210000100012002011000101200010000100000010000110101000000000000010110000000001
10000000100010001001001000011010000011011000001000100001011021000110010000011101101101011100000020000001
10000000101110111001000101110000110100110001000000110011000012100010101110100000011000010000101122100011
12001000101001000000010001000001100110000100101001021010011000200000000000000010010100000101110012001001
10100000100100010000000000100102000010200121000010220012000111011000011000001101000021000011000100101001
10000010101100100010010110100000010000000020000001010000000101001100001001000100001021000001001100020011
10001000010000110010010000110000010000000001000000010000000001010010100001100000000110100110200000010101
11000211011000010000010101000010001000000100001000102000110000001011011000010000000000101100110010000011
10000121001010000000001010000000001201000000010010001000001000000100200000010100001020010001002010001001
10010000000001000111010120001000010001000001101000100020001100000000200101100101011110000000010010000111
11010001010000000000000000001001000000101110000000000000100100110011021001100000100000000000001010111001
11000100010010001021100110101011110010001010100011200011201200010011020001000110000201110000000001102021
10000010100001100101001001010000000010100001111000010000000000000001000001000100000000100000000100000001
10000100000100000011000000010000001111010000000001101000000000001110000010000000000000010000000010101121
10000000000000000002100010010001010000111000100000100010111010110010000011000001001010000000100010110011
10001000000011000100100110000200000000210002101000000001100001002000110100100100000000000010000101001021
10010000000000011101101000011001010000101002000010000100001000101000100001000000101100000010002012000001
11011001001000210100000000000000100101000001010012010000020110100101101000000112011000000100110000100011
10001000020100100000000000000000100000000000101010000100100000000000000101000000100100000000000100020001
11001000001000000120011100020011000000010100000000100000010000100000010100201001000000020101010010000011
11000000210000011010000001000001100001001020001000000001001000000001010001100000010100001110112100000001
10100000100001101100001002000100000011000000000000010000000100000000001110100000000000210011001000000111
10000000000100201011000110211000010011001100000000000010101010010100000111100000100000001010200010011001
10000001000000000000101001010100000000010012001001110100100001000000011020110111000000000000000001001001
10000010001010000000000010000000001001100001010100110010000011000100011000000000021110001012000000001011
11100000100010010000200000001100001100000110000010000000010010101000020000012011100000000000112010000001
10001010000100000010000000000011011000000110010010101101001000002000010000010000000100001010000000001001
10000000011000100000000100010010010001000000100110000000000111000010001002000010110000010002020000000111
10020010002200001101100100000111000100000000000111010000001010000100100111111000000110100000000100000001
10011000211000000000010000000111010000001100100100100000000010110110002011000001000101000201000012010101
10100101111000000112010000100000000001001000100010100020100000010000000011000010020112000020000000000221
10010000010110100000011000010000100100011000010000011000000001000100000000100110110010010000110112010011
11000000000001000101000010001010000000000110101000000000000000000000000000010000100010000100100010000011
11010001000000001001000012000200010000002100000000000000110000100001100010100001110000000021102000001001
11120000010010100001000010000110110100001000000000001000101000001000101000001002000100010000100100000001
11100011010001110010010000002012000121000000000000001000110000000010001000000000111100010101000000000001
10000000010000101100000000001010111101000010000010000100000100000000001000010010000000010002101110000001
10001010010011101000001000000001010000110000010100010000000110001011001010000001120201000000010000000011
11011000100100101000000010000110021000111000000020000010000000220000000000010000000001010001000100001001
10000000100100111000010100000101000100010100000000110000010100000101000110000101000000100000101011021001
10020001001110200001000110001000100000000000111010100021000000010000020010010110100000000010001200210101
10010110000102000000000000000100100101210000010000000000101000101200011000001001000011111010101200010001
10011000002020020010000010000000000110000200000000010000021000000001000211210100000011010011101000000011
11210100010000010001110000101100000001000100000111002000000001000001101000100001101010011010000000010011
10000010010000110001000100000110000010000100020000000100000000020011000001101010000100001001001012000001
10010000000100000000000101100010000000102000001000121012110010110000000000001000001000010100011000001001
10000102010111011001001111011101110210000102000000010110101000111100000001000000001021000000000000000001
10001100001010002100002120000100010011011000011100000010200001000000000011000000100000010100012000002001
10000001100100110010000000010100000100020000000000100001000100001100001000000001101001000110020000010111
10010011102000000000002000110000000000110101001000000000022010101011000010000000010111010010000102100101
11100210000110001101100021012000100010000000001100100000000001001000100010001000000010000010100000011101
11000010010001101000001101010010001010000001011011000001100101101000000100000100100010020002100010001111
10001100101000100001000001200100000000111001100000001010000000001000010001000001002000001010011110100101
11010000001201002101000102010000001010000001000011110001010001010000010121001000001001100000100111001011
10000000000001011001010000021100000100000000000100100011001000000200000000000100000011011011001100000001
11010000012010000010001010000000001100201101102000010010011001010000002001001011101100001001100010100101
10100000100000011111000001000100110101010010000000010010010021000001010011000010121002100001101100110101
10000000001001010010011100010011010000110101000010001001100111000001010201002000010000001001001001000101
11111111111111111111111111111111111111111111111111111111111111111111111111111111111111111111111111111111
