R 1920 1080 
NO ./path_to_the_north_texture
SO ./path_to_the_south_texture
WE ./path_to_the_west_texture
EA ./path_to_the_east_texture
S ./path_to_the_sprite_texture
F 25,25,25
C 0,126,233

11111111111111111111111111111111111111111111111111111111111111111
11001100000001010001000000010010000000001200010010100100000010001
10111012102100100102001000000000110012010000100001001001100001101
10101100000000001110000100000110110011101000100010000000101000111
10000000000101000001001100011010110000000110001000000001100000111
10002112011000100000010110100000100000000010101101000010100021001
10010011100000100000110001000110020000001000100001001002000100011
10100100100020010000002000000000100000000100010001001010110010101
11001120110100001100001010000100010001102010010011100000010001101
10100000000001000002000000000200010100000000000010100011000010101
10000010010100000000000000000000102100000001000000011102000000001
10110000001100101010101100001000110000010000110020001100011100111
10000000000101010001100120002001110010010000000000110010001111001
10000000000000000010000000101011010000001100000000101100011001001
10100011000001000000110010001100010101010100000001000000111000101
10210000100000000000000010111000000100001102000001010101000000111
10000010000010012210000000101101000110010110001000001000000002011
10110000102000000001001000011000000000000000000000100000010001001
10000202000000001111010000000001010100100110010010010100000010001
10000001200000100100100100000100100000001000001010110000110011001
10001110111100010100010000100000000011000110000000011001100001001
10100000010020001000020000001000010000001110000100100000000002101
10010000001001000011000100000000010000010010000001000010100000001
10100000100001010000120001101000000000010002010001001000000101001
10000001001000001010000100010100111210000010100101100000002200011
10010001000010000100001011000100000010000100000000000100000100001
10001002101000000000001100001011000100010100100101210110011100001
10000100000000100000001000101110001010100000001000001200000001001
12001000000100000012000001000000010000111100000100000000010001001
10021000100000001020000000000011000011000110001010101000000000011
11000011010001000101011000001100000011001001200010010000000000001
11001010000210100100001200000000001000100000000000000010000000201
10001101010001001100100011001000020010001000100001000010000100101
11021012010000001010100000111000000000101000011100001000000101001
10100002000001000100000011000000001010010000001000001001010000011
10000000000000000100002001100100110001100000000010100100010000001
11111000000000100010010000001010000000000012001110011000100100101
11000100101100100000000001001110000000021010010010000100010001101
10000011120010201011011110000100100011110100000010020000001001101
10010000110000000000000000100000000000000000001001101000000000211
11011001101010110100120001000000000000000001000000010001100010001
11000000100000000100001100100000000100001210100110100000000000001
10010021000000000110011010010000001010000000000000000001000000101
10201101100000000000110200000100010002100000000000001010011000001
10001111000001000000000000000000001001001010000000001110011000021
10001011010000000111000011000020000010000000200101110000101010011
10001111000000100011001000100000000000100001000010002011001000001
10100010111101000000010010110010101210000100000010000010002121101
11100000010000000100100120000000000101100000000000201010010101001
11110100100011000000020100000100001000020002010101110000101000001
10120001100110001100000000200000000000000110111200001000000010011
10000000000100010001010000011000000001000001100000000001000001001
10100001000011010200100000200000101100011011000000010000110100011
11000100001100000010000101000100102000110102000001000000000001111
10000111000000010020101201100110000000100120000001100000000100001
11110001010001000000002001022000101001000010001001000101000000201
12100000000101010000100010001000000000100110000000100011110101211
11010001100100010000000101000000010100100000010001000001000000001
10000000010100001001100010000001001100000000000001001020020000101
10000110012000200110201010010001001010000000100011001000100000001
10100000012001001000000100000010002000110110001010010010000000101
10101000100000000010000001110000100000100000111000012000100011201
10000101011102100011000000000011010000000010001100001010010000001
10101010000002000000100000111000011001000010000000000000001000111
10000001000001000010000100000010000100000001010000010100010100001
10110101000000110100000000111012101000000011100001001001000000001
10000000000001000000000100001010100001020000000000100100000101101
11000210101000000000011011001001010000100010010010010010110111011
10110110100100000100000001000000000100000000011000000101100000001
10111000011001111001001000000000000012100000000000100000001010011
10011010200000010101000100002000000000100001000100000100011010001
11000000000000101000000000100111000000012000010001100000000010001
11111010000000010000000000110000200021200000000000000100000000001
10001100000011000010110001000000000000000000000000000022010100101
10010011100100000000000010001000010010100000010111110010000000101
11101000002100000000000000001002000200000001010111110000010111011
10001002100110000100000111001000000100000000000210000010000000011
12001010000110000120001000010110000000100001001001000101000000011
10100001100100011001200011001000100000010100000000011010101120001
12010100210010000000010000100100010100010100000001001011100000011
11200001100101000101000000010000000010000000200110100002000020001
10001000010020000000000001000100010100011010010002000100111200001
10000010000010010010001001100101101000001011000100100010000000101
11001100011000020001100000000011120100000010000000000100001100001
10000001111010000001102100200000010210200001000001221010001000011
10210100000000000000000000100010000000010011100000012001000000101
10000100000011100010000000101000001010000100000001000001001000101
11100000012000000000100000000100000001010000011011000100010010111
10100102000000000000010000000001010000010000000000101100000000001
10210000010010001000001001000000010100000110100111010010100000001
10001110000110011010000100000100000010000010001010101000100002121
10100000000000010000000010000010201010000010110000010100010100011
11010001000010001100000000100001000001111000100020010100010011011
10000000101010000000100001010000100100001001000001000100001110121
10010101000000000010000001000101010101100100000102000101001000101
10000011011100011010000000010000010010001200000001010010010001001
11011020010000000000000010000000001001000100010010000101000001011
11010000001000000000000100001000000100000111000020010210000001001
1000010000001W010011000000000011010101000000000000000000000011111
10000100000000001020210100000100100010000010000101010000100000001
11111111111111111111111111111111111111111111111111111111111111111
