R 1920 1080 
NO ./path_to_the_north_texture
SO ./path_to_the_south_texture
WE ./path_to_the_west_texture
EA ./path_to_the_east_texture
S ./path_to_the_sprite_texture
F 25,25,25
C 0,126,233

11111111111111111111111111111111111111111111111111111111
10000001100000000100000100101100000010000000100000000101
11000000011000000101000000000000000000010100100000000011
10000010001001200000101011000001100001111000101110010001
11000011010000000001010000101200000010001111000000100011
10000000000200100011100001100100010011000101000110001001
10100001000000011011001100000200000000001002100011120001
10100010101000000110000001001000010000001001100000010001
10001001000000010201000101010002020000000101000100001101
10000110000000001210100000010100000000000100011011000111
10000001000011010010110100000000010000011000100000000001
11010010000000000000100000100000010000000000110001100021
10020000000100101000000100012000000101010000100010000101
10001000000111000100100100001010000000000000000010002001
10010000000100010000000000000001000000001010000010010001
10010000000000000000020100000102010010101000001000000101
10000100100010000002011001000000001100101011000000000011
11000100002110000100000010000000000010000001100000000001
11010020000111200100001000110000000120001100000001010101
10010000011100000000000000000100000101000000000000110011
10001000001000000000200010020000000000212122010000010001
11010000000000000001100000000010000001111010100010010001
10210010000000000000000000001100100000000010200000000001
11000010010000020001000110100101001010101000110010000001
10000100000000000000000010011002000000100010002000000001
10001000000000111011000001100110100001010011000210001101
10010001001000002100110021000000100000011000011011000111
10000001000100012000000100010001000101000000010010111011
10120100010000000101000000000012100001100101000001111001
10001011010110000001000121010000001010010020220000100001
11010010100011000002100000000000000101000100201100010001
10000000101001000010010000000111010100100000010100000001
10000100000000000000110002000000100000000021100000010001
10100010010000101100210010002000000100000100111111110001
11011000001000010011110011100000100210010101100100000001
10011011000000011000100010011010001000101000000020000011
10010001011100000000000000110100000010000100000010010001
10000011001010000100000000000001001001001100010000000001
10001000000011001110011000000000000001100000011100000011
11000101001000100100111000011110011000001000020000001001
11001000010000000000010010000010001000010010011000111011
10000000000001110010001102100100101101001020000001000001
11000100000010002001101001000000101021011020100110100101
10000000001100000011010010101010110010000000202000001001
10000000000220000110000101001012120100000000020200000211
10200000000101010100000000000001000011000001000000101001
10010101000100002000010000011021011000100011001001011001
10120020001110001100010000010210100001100000100100011001
12000010010010000101010010001000011000000100000100010011
11000001000000000111101010100010000002001011100000200011
10000021011100001011000000121000100110010000001100100011
10000100011010010011001100000010010100100011001011210001
10000010000110000000000021000101000100010000000001000011
10100100000100100001100020000110001010011001001010000001
10110002101110100000100000000001010110001000001000000101
10000000101001001000010010000000001100000000000000100001
10210001110000010010000200001100000010000100000000100011
10000010000210000000202010110000100100000000100000100101
11000001000010001001002110120100010002111000000100010001
10010010000100101001201010010002001000002100100000100101
10001000021101100000100000010001010102001010110100100001
10011100001010000000000100000000001001000001000100010001
10002000111000100000000001001111001101100010000001020011
10000011000000100000000011001010000000101000111001101001
10010010100010000001011000110010000100010000000002000001
10000000000011000000000100100010000001100011000000020001
10000000000000000100100011010010000000000010200000000101
10000000010000000000010000000000100200011011000000001001
10000000000012000100010001001100000011000110101110100001
10000100010010000100000000010010000000100100020000000011
10011000011101000000000000001000110000100000000000000001
10101000001001000001000010001000001010000101000001000001
10001000100100000010000000000001000000000001011001000001
10001000011000000212010001001000001001101000000000001111
10011000000000000000100110001101000000000000000000010111
12000000010000001100120000110000010010000010010101010011
11000100100000101000001000001010000001010001000000000001
10101001001000001001002001010000000111001000100111012111
10000000100101000010001100000010101100101000000002100001
10000002000000000011000001000000000000000000100011101001
10101100100010000000000100000000001001000001000001000001
11001111100000010000000000011001200100001101000000001201
10120001100010000000000000100100000000001210001000000101
10110000000000011110102000100000100000000000001000010011
11100100101100100001010001001010000010010100000000000011
10100001100100000000000001101000000000001001000101000001
11102011001101010000000110000101001020101000100000000011
10000120000000000000000100002000101001000000000000001101
10010002100000000010000000000100100001011000002110010101
11100010010000021000001100000101000100010100000000000001
10000002010100010010001000010000000010100001010011110021
10000100011020000000000110000000011000100110000000001001
10100001001101101010000000110100000200000010000010000E01
11111111111111111111111111111111111111111111111111111111
