R 1920 1080 
NO ./path_to_the_north_texture
SO ./path_to_the_south_texture
WE ./path_to_the_west_texture
EA ./path_to_the_east_texture
S ./path_to_the_sprite_texture
F 25,25,25
C 0,126,233

111111111111111111111111111111111111111111111111111111111111111111111111111111
100000000001010101000000110010011101010010001201001000010000001101000100011001
100100010010020000100000100100000001101000100101100100000000000100000000000001
100100011200010010100101010000000012101000000011101000000011010100101100000001
100000101110100000010011000000000100000000000000011000000101201100000000200101
100001000101001010000010000100201000000011001110221101011100010000011010000001
111010010111010010101100000000000000000111010010000100010100100000100100010011
110010101102100110000000100001000000001000110000100000100000002110000000000101
100000100000010000000200100000001121101001101001111000011000011102011000101001
110100000001000112000200100100000100000100001100100000000000211100011101000001
111000001001110100000120011000001000000001000000000010001000010000010001100001
100101010000102111100000100011000200011000001002010010100011011100000000010101
100010010000100001000000000001000010000011000000000100101100001011000001000001
100001100102000001100021000000010001000010200000010000010100020001000200000001
101100000000000100120010001100001000120000112010100010011000000000001100100101
100100010100011000100100200100000000000000100002000200100011002000000110000001
101001000210100011000000001000010100000200000000001200100001000002100000101011
100101100200001000001000011020010100120010100101000100000100000100110001000001
111001010100011110010010000000000110000000111020000000000000000102000000110001
101000000000001210100011010000100101100101011100010000000100001000000210100001
100100001100111000000110000000000110000010000000100001011110001020010010000001
100010100001000200100000010000000000010000100011110110000110100000100000000011
100000100010111001000001000011000011000011111001001002000001100000000001000001
101101010100000101010000000000110100010000000200000200100001100010110100000001
100200100000010110111000001000001001010010000000100000001000000000110001000011
110100001000200100000101001110100111000000000101011001000000000100010110200001
100000000011000100011001001001101000100001100010000000000002001010001000211001
100120112010000010000011000000000000010000101010000010010010000100010000001021
100001000100020100100002000002110000000010101200000100010102000001000000001011
100010010000001000201001110000000001100010000001010000001000100100110001100001
100001100110000100000000000010001101110001000000000101100001010000100011000121
110101000000000100000000100000100010201110010000010000110010001000110000110001
110100000010000100011100001100010000000000011021010000000000000010001000010001
100010000021010011000010000120000000000000200010110010000000000110010000020011
111000000000001110000100010000000111110000100001001000001100000000001000000111
100110000000010010001000001100000000000101010010000000000001001010000001000001
100110101011100001000000100001110112011000000100100000000010010000020001000101
101000000011100000010010000000000110000010100000000000111100000011000001100001
100000010101101000010101000000010100010010000010011010000000000101000010000101
101002020001000000001200100010001000000101100000000000000100001001101001100001
100000000000100010101000000000000000001001000000010111010000100100000000000001
101000001100010000000000100100000020101100000001100100000000100100010000010001
100000100000001000110010000000010020100110000000010201000110000000101100110101
110001001011000000000000010100100001000000100000011000000100100020000010001001
110102001001000000000000010210000100101000001100000010000000010200000100000101
110000000000010000000110010000000110001010100100000000000001S01100001000100001
100000000000000000001110010011010001000000000001000000000100000000001010110001
100000010000100001010010001100011011011001000001001000100000011001011011002001
100000000001011100000100001000020010000001002100000120000012000010100012000011
100010011100000001000002001001000010001000010110111001001010000000200001000101
100120110001211000110000110000100100110000000100010011110001020110000100001001
100100000000100000100000010110010110000010102010000000101010100110010001000001
110010010000000001000000110010120010020001100100001001000000000000001100000111
110101001000000100100001101011000100000110101010000001000100101020020101010001
110100100021200001011200010000000001000000000011000000000012010001200000200001
112100010000011100010100000010000000001000000100010000000000001101001010000011
100011100000000100100021110020100000000002100001011010200000012101100000100001
101000000000100001000000000001000000002020000010000001010010001100000100010001
101101111000000000000000000000110000100100100000001101010110001110001101000001
111000000100110000000000010000001000021100010000200011001100000010000000000001
100001001002010000000000000110000000100100111011100000001100100000000001000011
100001000010000100010011000100000000000001000000000000000100000000100010000201
101000010010010110000011101000000111101000000001011100001010002000000000010001
100000000110110020010001000000000010000100000001001101000100100001000001100011
110000010000000021010100100000100010011100010100000001011010000000001001000101
111011000000010110000010000010000000000100001010011000000000100100110100001001
100000010000010000000000100000001100000100010100100000000000001201002201000001
101100000010000010000001010011101010010010010000000000001100000010002000000101
110000010110000100010000000001000001000001110010000000000000000001000000000001
110001000101101100000000010100010000100000000000110000100001000100000110001001
111110100010100000001200100000000000000000001000000000000000000000010201001001
101100000001001000001100002001001100000100101000000000000000001010010010001001
100000010200100001112000100001010000010011000002000101000100000010100000110011
101110000000010001111100000100000000000000000110010000001000010000100001010001
100100000000002101202000100000000010001001001000001000000010000000001001000001
101000000010100010000200000111000101000010000101020000110100020000000010111001
101010000100000110100000100100010000100000000001001000010200000101010001001001
100010100100101100001010001000011000000120001000000001000000120010001102000001
100000000012002100000000001110010000000000100010100000101001001000001000100001
102020100000011001000000100000200100001000000001010000010001000100100001200001
110001102020000010010000100100000110000001001001000000110101000000110100000021
102010012011110010000000011010000100001001001211010100000000000000000000100101
100000010110010010011100111000020000001000010100010010001001000010000000001011
110000011000021000001000000000000100100000000001101100100000100000110100110101
101210000000000000000000020211000100000001011101000000010000102100001100101001
111111111111111111111111111111111111111111111111111111111111111111111111111111
