R 1920 1080 
NO ./path_to_the_north_texture
SO ./path_to_the_south_texture
WE ./path_to_the_west_texture
EA ./path_to_the_east_texture
S ./path_to_the_sprite_texture
F 25,25,25
C 0,126,233

11111111111111111111111111111111111111111111111111
11111110111110111010101100012111111111101010110001
10111010011111110111011011111101111111101000101211
10111100110100210020101011011111001111110112111211
11111011121111111101111011211112111111111011112111
11000110001112110111110111110101100110121011010011
11112111101111110201111011111111201111111110111101
11111011112001110111011011002111211021111111011111
10021101012101111111001100111101011111011001111101
11210111111110111111111111111111011012010010111011
11112001100111111010201110011001121211001112112111
1021110202011021111110110W101101101110112111111011
10120111212101111111011110101111112110111111011111
11111111111111011100111010120011111110111101110111
11111111121111111121201101001111111101111101111011
11101111111210011021211211122201112102111112100111
10110111121221121111211110110111111111210110110111
11110111111111111010011111110001111121111211111101
10111211111211010121111111110111111011100101021111
10111121101011111101120201101111211111212121021101
11211111111011110000110121211101110111111012211111
11010221101111111211011111110111111111111110111211
11100111111111011111111012010111111200111111100111
11111012121110101011011111010111001100221101211101
11121211111101211110121111011111111111101111101011
11212111011011211111111121111011110111011112010111
12110111101111111111111111010102210110111112011121
11110111211010111001112101111002111022102121111101
12112110111001001111102011210100001111011011011211
11111011121010200111010111111110111111011110111111
11211011111111110110111111101111111111101111111111
11010001101111111012111112111101101121112111101111
12101120011010110110111111111111021211100111101021
11112111212110101101111111011111011101001111011101
11111211111101011011101111111111102010100111111121
11211112011100111011110100111111111202211001010111
11111001110112111111110211111001121110112101111011
11101111001121121111110111111110112111001111111111
11102101211111011211111011101011111100212110111211
11111101221021111010110121021111011101111011111111
11211101111111100111111111011000111011111101021101
10111111200111100110110112120101111021110111001111
11111121010110110011111111101101101121111121110101
11122111001110110111211211110112101111010120111111
10101120111011111111012011101110100111111100110211
10111111111120110111011110121101112111001001111111
11111211011111100111111111102111110101011111111111
10121111121011111111111111111111011111111111111011
11111011101101110210011001110111201110111111102101
11111111111111111111111111111111111111111111111111
