R 1920 1080
NO ./path_to_the_north_texture
SO ./path_to_the_south_texture
WE ./path_to_the_west_texture
EA ./path_to_the_east_texture
S ./path_to_the_sprite_texture
F 25,25,25
C 0,126,233

11111111111111111111111111111111111111111111111111
10000000100000000000000100002000000000000000000101
10000000000001000000000000000000001000000000000101
10000001000010000000000000000000000000000001000001
10000000000010001100010000000000000100000000000001
10020001000010000011001000000010000000100000001011
10101000000001001000000000100000000000000100000001
10000001000000000001000000200000001000000100100001
10000000000000000000010100000001000101010010101001
10000000200000000000000000000010000000100000000011
10000000000000000001000000001000000000001000000011
10100011010000000010000000000100000000000000000101
10011000000000000000000000000000000000020000000001
10000000000000000000010000000100000000000000000101
10000000000000000000000000000200000201000100000001
10000001000000000000000000000001000000000000010001
10100000000000000001000101000000000000000000100001
11000100100000000000120000100010000000010000100001
10000000000001000000000000000000001000000001000011
10000100000000010100000000000000000200000000001001
10000000000010000000010000000000000000000001000001
10000000001000000000000001100000100000100000000001
10000000000010000002000000000000000000002000000001
10000000000000000000000000000100100000010000000001
10000000000000000011000000000100010000000100002001
10001101100000000000000000000000000000000000110001
10000010000001000010000100000000000110000000000001
11010000111000002001000110000000010000000000001001
10000000010000001000000020000000000010000000000001
11000000001000000010000010000000000000000000000001
100000002000001000020000000001000000000000000N0001
10000000010001000000000000001100000000000000000001
10000010000000000100000000010000000001101000000011
10100000000000000020000100000000100001000000000001
10010010001000000000200000000000000000000000000011
10000000000000000000000000000000000000100010000101
10100000000000100002001110000010010000001010000101
10000200000000100000000000000001000000000010000001
10000000000000000000100000000000011000000000000001
10000000020000000000000000000000000000000100000001
10100000000000000000000000000000001000000000000001
10000000000000010000000000001000000002000000100001
10000000000000010100000000000000000000000000000001
10000001000000010000000000000010200000000000000001
10000000000000000000000000000010000100000000000001
11010001000000200010000000000000010000000000201011
10000001000000001000200000000010000000000000010001
10000001000000000000010000000000100000010000000011
10000000000000000000000001000000000000000000100001
11111111111111111111111111111111111111111111111111
