R 1920 1080 
NO ./path_to_the_north_texture
SO ./path_to_the_south_texture
WE ./path_to_the_west_texture
EA ./path_to_the_east_texture
S ./path_to_the_sprite_texture
F 25,25,25
C 0,126,233

111111111111111111111111111111
100000010102010000000010000001
100000000000000000100010000001
100000200000100000000000011101
100010001000000000000000000011
100000000000010000000000000001
100010000000000000001000000001
100000000000000000000000200001
100000000000000000000100000011
111000000000000000000101000011
100000100000100000000000100001
101000010000000000000011000001
100000100000000000001110010001
110000000000000100000010000101
101010000000000100100000000001
100000001000000000000000000001
100000001000000000000000000001
1000000000000001000010000000S1
100000100000000001000020000001
100000001000000000000100000001
100000000100000001001000000001
101000000000000000000000000001
101000000000000000000010000001
100000000001000001001000000001
100100000000120000010000000001
100000000001100000000000100001
110000000000000012000000000001
100000010001000000002000000021
100010000000000000000000100011
111111111111111111111111111111
