R 1920 1080 
NO ./path_to_the_north_texture
SO ./path_to_the_south_texture
WE ./path_to_the_west_texture
EA ./path_to_the_east_texture
S ./path_to_the_sprite_texture
F 25,25,25
C 0,126,233

111111111111111111111111111111
101111101111100111111111101111
111111110111111101111110101111
1021111011111101011002211E0111
111101101001121102111111111101
110111110111100111110221101111
111110111011101012121111111001
101110111110111110111111012011
111111111012111111111211111101
111200211121101101110111011011
111200101101210100111100011111
111100111110111010211101010111
111110111211111101111110110011
111120111110121111111121111111
101110111011101000111111101021
101112110010112111010021121101
110111111111101111101212111011
122110111111011010211111111001
110110111211111011011111111111
102112011111011101121112111111
110111102110100110100111111211
111110111021010101111001111111
110111111011111011111001010011
101111111101010110201122211011
112111111012200120020012110211
121110111111121102001110111021
101001001111011101111101221111
101121111111011211111110110101
111111121111120101111111112111
111111111111111111111111111111
