R 1920 1080 
NO ./path_to_the_north_texture
SO ./path_to_the_south_texture
WE ./path_to_the_west_texture
EA ./path_to_the_east_texture
S ./path_to_the_sprite_texture
F 25,25,25
C 0,126,233

111111111111111111111111111111
101010102101110200001110110001
100001010110010111110110011001
100011010011200110000010211011
111001010010110001101111001021
111110101100111001100011000111
110110011011100011101100001001
111011011011101011000101110011
111000011200111101111210102101
110110101011100100110100002101
100110001001201111001110120011
101101112111000101001111000011
101010000011001101211021110011
100210101100100001121100101111
112000001021001101210011110101
110111101000011111100111111101
100001100102011000011110010021
10011111111001000W100111001101
111110000011001001110000111011
111201000011110010101000101111
101100120000010111211011012111
101100101110100111101110000111
111020010010111100002011101011
101110201010012010010000101101
101200000001110010000010110001
100010011000001101101111110021
111011210101111101000000011011
112210011011110111100100010011
100110111021010000111102001111
111111111111111111111111111111
